meticulous=showing great attention to detail
zephyr=a gentle, mild breeze
quixotic=exceedingly idealistic; unrealistic and impractical
banal=so lacking in originality as to be obvious and boring
juxtapose=to place or deal with close together for contrasting effect
vehement=showing strong feeling; forceful, passionate, or intense
nascent=beginning to develop or exist
furtive=attempting to avoid notice or attention, typically because of guilt or a belief that discovery would lead to trouble
tenacious=tending to keep a firm hold of something; clinging or adhering closely
lexicon=the vocabulary of a person, language, or branch of knowledge
ambivalent=having mixed feelings or contradictory ideas about something
ephemeral=lasting for a very short time
gregarious=fond of company; sociable
halcyon=denoting a period of time in the past that was idyllically happy and peaceful
quintessential=representing the most perfect or typical example of a quality or class
xenophobia=dislike of or prejudice against people from other countries
impetuous=acting or done quickly and without thought or care
nocturnal=active during the night
kaleidoscope=a constantly changing pattern or sequence of elements
ominous=giving the impression that something bad is going to happen
diaphanous=light, delicate, and translucent
reticent=not revealing one's thoughts or feelings readily
whimsical=playfully quaint or fanciful, especially in an appealing and amusing way
alacrity=brisk and cheerful readiness
verbose=using or containing more words than are necessary
cognizant=having knowledge or awareness
harbinger=a person or thing that announces or signals the approach of another
ubiquitous=present, appearing, or found everywhere
pernicious=having a harmful effect, especially in a gradual or subtle way
mellifluous=sweet or musical; pleasant to hear
facetious=treating serious issues with deliberately inappropriate humor
eclectic=deriving ideas, style, or taste from a broad and diverse range of sources
truculent=eager or quick to argue or fight; aggressively defiant
nefarious=wicked or criminal
zenith=the time at which something is most powerful or successful
sycophant=a person who acts obsequiously toward someone important in order to gain advantage
obfuscate=render obscure, unclear, or unintelligible
laconic=using very few words
yearn=have an intense feeling of longing for something
pragmatic=dealing with things sensibly and realistically
idiosyncrasy=a distinctive or peculiar feature or characteristic of a place or thing
voracious=having a very eager approach to an activity
ruminate=think deeply about something
esoteric=intended for or likely to be understood by only a small number of people with a specialized knowledge or interest
lethargic=affected by lethargy; sluggish and apathetic
opulent=ostentatiously rich and luxurious or lavish
grandiloquent=pompous or extravagant in language, style, or manner
didactic=intended to teach, particularly in having moral instruction as an ulterior motive
umbrage=offense or annoyance
insidious=proceeding in a gradual, subtle way, but with harmful effects
wistful=having or showing a feeling of vague or regretful longing
myriad=a countless or extremely great number
tantamount=equivalent in seriousness to; virtually the same as
cacophony=a harsh, discordant mixture of sounds
enigmatic=difficult to interpret or understand; mysterious
frivolous=not having any serious purpose or value
garrulous=excessively talkative, especially on trivial matters
acumen=the ability to make good judgments and quick decisions, typically in a particular domain
querulous=complaining in a petulant or whining manner
indefatigable=persisting tirelessly
soporific=tending to induce drowsiness or sleep
perspicacious=having a ready insight into and understanding of things
ebullient=cheerful and full of energy
trepidation=a feeling of fear or agitation about something that may happen
capricious=given to sudden and unaccountable changes of mood or behavior
soliloquy=an act of speaking one's thoughts aloud when alone
parsimonious=unwilling to spend money or resources; stingy or frugal
incorrigible=not able to be corrected, improved, or reformed
ameliorate=make something bad or unsatisfactory better
bellicose=demonstrating aggression and willingness to fight
paucity=the presence of something in only small or insufficient quantities or amounts
effervescent=giving off bubbles; vivacious and enthusiastic
vicarious=experienced in the imagination through the feelings or actions of another person
audacious=showing a willingness to take surprisingly bold risks
deleterious=causing harm or damage
perfunctory=carried out with a minimum of effort or reflection
sardonic=grimly mocking or cynical
eloquent=fluent or persuasive in speaking or writing
taciturn=reserved or uncommunicative in speech; saying little
loquacious=tending to talk a great deal; garrulous
ingenuous=innocent and unsuspecting
malaise=a general feeling of discomfort, illness, or uneasiness
intrepid=fearless; adventurous
erudite=having or showing great knowledge or learning
morose=sullen and ill-tempered
prescient=having or showing knowledge of events before they take place
redolent=strongly reminiscent or suggestive of something
sagacious=having or showing keen mental discernment and good judgment
torpor=a state of physical or mental inactivity; lethargy
unscrupulous=having or showing no moral principles; not honest or fair
exigent=pressing; demanding
fortuitous=happening by accident or chance rather than design
histrionic=overly theatrical or melodramatic in character or style
intransigent=unwilling or refusing to change one's views or to agree about something
jovial=cheerful and friendly
misnomer=a wrong or inaccurate name or designation